##########
#........#
#........#
#........#
#...@....#
#........#
#........#
#........#
#........#
##########