##########
#........#
#.######.#
#.#....#.#
#.#.##.#.#
#.#.##.#.#
#.#.##.#.#
#.#.####.#
#@#......#
##########